16,14
00050000030000
00060000040000
00111111111000
00111111111000
00111111000000
00001111200000
00001111001000
00001111201000
00001111000000
00001111000000
00001111111000
11001111111000
11781111111000
11000000000000
11000000000000
11000000000000
